1111111111111111111111111111111111
1E0C0000000000000000000000C0000001
1010010100100000101001000000010101
1C10010010101010001001000000010101
1P0000000C000000000C00000000000001
1111111111111111111111111111111111